[
    {
        "id": 1,
        "game_matrix": [
            [1,1,1,1,1,1,1,1,1,1,1],
            [1,1,0,0,0,5,0,0,0,1,1],
            [1,1,0,1,1,0,1,1,0,1,1],
            [1,1,0,0,5,0,5,0,0,1,1],
            [1,1,1,0,0,1,0,0,1,1,1],
            [1,0,0,4,3,1,3,4,0,0,1],
            [1,0,1,0,0,2,0,0,1,0,1],
            [1,0,0,4,3,1,3,4,0,0,1],
            [1,1,1,0,0,1,0,0,1,1,1],
            [1,1,1,1,1,1,1,1,1,1,1]
        ],
        "metadata": {
            "difficulty": "hard"
        }
    },
    {
        "id": 2,
        "game_matrix": [
            [1,1,1,1,1,1,1,1,1,1,1],
            [1,1,0,0,0,5,0,0,0,1,1],
            [1,1,0,1,1,0,1,1,0,1,1],
            [1,1,0,0,5,0,5,0,0,1,1],
            [1,1,1,0,0,1,0,0,1,1,1],
            [1,0,0,4,3,1,3,4,0,0,1],
            [1,0,1,0,0,2,0,0,1,0,1],
            [1,0,0,4,3,1,3,4,0,0,1],
            [1,1,1,0,0,1,0,0,1,1,1],
            [1,1,1,1,1,1,1,1,1,1,1]
        ],
        "metadata": {
            "difficulty": "easy"
        }
    }
]